0 0 50

13 7 0
13 8 14
13 9 7
5 13 2
5 14 14
5 15 6 

5 7 12
5 8 14
5 9 15

13 13 4
13 14 14
13 16 8

9 6 13
8 11 3
9 11 3
10 11 3

7 6 1
7 7 1
7 8 1
7 9 1
7 10 1
7 11 1
7 12 1
7 13 1
7 14 1
7 15 1
7 16 1

11 6 1
11 7 1
11 8 1
11 9 1
11 10 1
11 11 1
11 12 1
11 13 1
11 14 1
11 15 1
11 16 1
9 16 5


0 0 50


0 7 0
0 8 14
0 9 7
7 5 12
7 6 14
7 7 15

15 8 4
14 10 8

11 9 1
12 7 1
13 8 1
10 9 1
12 7 1
15 7 1
15 9 1
15 11 1
16 10 1
17 15 1
7 16 1
2 2 5
3 3 13


0 0 50


0 0 12
0 1 14
0 2 15

1 0 4
1 1 14
1 2 8

17 5 11
16 5 11
15 5 11
14 5 11
14 6 11
14 8 11
14 9 11
14 10 11
15 10 11
16 10 11
17 10 11
13 6 11
12 6 11
13 8 11
12 8 11

12 7 3
14 7 3

16 7 13

8 13 2
9 13 14
10 13 6

17 22 5

13 22 10
14 22 14
15 22 9

17 18 11
16 18 11
15 18 11
14 18 11
13 18 11
12 18 11
11 18 11
11 19 11
11 20 11
11 21 11
11 22 11
11 23 11


0 0 50


12 2 12
12 3 14
12 4 15

11 12 4
12 13 14
13 13 8

17 0 0
17 1 14
17 2 7

16 10 2
16 11 14
16 12 6

11 11 10
12 12 14
13 12 9

11 3 13
16 6 5

16 3 11
16 4 11

11 8 3
10 8 1
12 8 1
13 8 1
14 8 1
15 8 1
16 8 1
17 8 1

10 9 1
10 10 1
10 11 1
10 12 1
10 13 1
10 14 1

11 14 1
12 14 1
13 14 1
14 14 1
15 14 1
16 14 1
17 14 1

14 13 1
14 12 1
14 11 1

13 11 1
12 11 1

17 3 1
17 4 1

15 4 1
14 4 1

14 5 1
14 6 1
14 7 1


0 0 50


12 2 12
12 3 14
12 4 15

11 12 4
12 13 14
13 13 8

17 0 0
17 1 14
17 2 7

16 10 2
16 11 14
16 12 6

11 11 10
12 12 14
13 12 9

11 3 13
16 6 5

16 4 11

11 8 3
11 9 14

10 8 1
12 8 1
13 8 1
14 8 1
15 8 1
16 8 1
17 8 1

10 9 1
10 10 1
10 11 1
10 12 1
10 13 1
10 14 1

11 14 1
12 14 1
13 14 1
14 14 1
15 14 1
16 14 1
17 14 1

14 13 1
14 12 1
14 11 1

13 11 1
12 11 1

17 3 1
17 4 1

15 4 1
14 4 1

14 5 1
14 6 1
14 7 1

0 0 100
0 0 100